25
 5 1 4 5 6 5 1 4 2
 1 7 3 5 1 4 1 1 2
 3 4 1 2 4 7 3 5 1
 2 1 6 1 1 2 2 4 4
 4 3 2 5 7 2 1 4 3
 2 3 2 6 5 4 1 2 3
 3 4 4 3 1 1 4 5 4
 1 4 7 3 5 3 7 3 4
 3 3 6 1 5 4 5 1 2