20
0 0 0 0 0 0 0 17
 4 1 4 2 6 5 6 1 3
 5 10 3 3 10 1 4 10 5
 10 3 3 5 9 1 6 3 10
 6 2 6 6 10 3 5 4 3
 5 5 2 3 7 1 6 3 6
 2 5 4 4 9 4 3 6 2
 10 2 3 9 9 9 5 3 10
 4 10 7 5 9 1 7 10 5
 3 3 4 1 10 1 2 1 1