15
0 3 2 2 2 0 0 0
 6 2 3 4 5 6 2 3 4
 1 7 1 2 6 2 5 6 5
 1 4 1 1 2 7 6 4 3
 4 6 2 3 6 1 5 4 6
 1 2 1 3 7 1 4 1 2
 1 6 4 2 2 3 5 2 4
 3 3 2 3 1 4 1 5 6
 1 4 7 5 3 2 7 2 5
 3 3 4 1 6 3 3 5 1