5
 4 1 4 2 6 5 6 1 3
 5 7 2 3 1 1 4 1 5
 4 3 3 5 6 7 6 3 5
 6 2 6 6 5 3 5 4 3
 5 5 2 3 7 1 6 3 6
 2 5 4 4 6 4 3 6 2
 3 2 3 6 6 4 5 3 6
 4 3 7 5 5 1 7 6 5
 3 3 4 1 4 1 2 1 1